111111111111111111111111111111111111111111111111111111
1000000000000000000000000P0000000000000000000000000001
100K0000011001011101010001100010101110101010000000K001
100000000101010101010100111100110010001110100000000001
100000000100110111011101000010101011101010100000000001
100K0000000000000000000000000000000000000000000000K001
100000000CCC0CCC0C0C0CC0CC000CC000CC00C0CCC00000000001
100000000C0C00C00CCC0C0C0C00CCCC00C0C0C0CC000000000001
100K00000CCC00C00C0C0C000C0C0000C0C00CC0CCC0000000K001
10000000000000000000000000E000000000000000000000000001
10000000000000000000000000000000000000000000000C000001
111111111111111111111111111111111111111111111111111111
