1111111111111111111111111
1E0000000000000C0000C0001
10100101001000001000C0001
10100100101010100000C0001
1P0000000C00C0000000C0001
1111111111111111111111111
