1111111111111111111111111
1E1000010000000C0000C0001
10000100001000001000C0P01
10100100111010100100C0001
100000000C01C0000000C0001
1111111111111111111111111
