111111111111111111111111111111111111111
100000000000000000000000000000000000001
100000010111010100011111101K11101010101
10010K01010101010011100011KE1000111K101
1001C0110111C111010000100KK00010101C0P1
111111111111111111111111111111111111111