111111111111111111111111111111111111111111111
1000000000000000000000000P0000000000000000001
100K00000000010111010100011111101K11101010101
1000C000010K01010101010011100011KE1000111K101
1000000001C0110111C111010000100KK00010101C001
111111111111111111111111111111111111111111111
