111111111111111111111111111111111111111111111
1000000000000000000000000P0000000000000000001
100K00000110010111010100011111101K11101010101
1000C000010101010101010011100011KE10001110101
1000000001001101110111010000100KK000101010001
111111111111111111111111111111111111111111111
